*	*	*	*	*	*	*	*	*	*	*	*	*	*	*	*	
*	 	 	 	 	 	 	 	 	 	*	 	 	 	 	*	
*	 	 	 	 	 	 	 	 	 	*	 	 	 	 	*	
*	 	 	 	 	 	 	 	 	 	*	 	 	 	 	*	
*	 	 	 	 	 	 	 	 	 	*	 	 	 	 	*	
*	 	 	 	 	 	 	 	 	 	 	 	 	 	 	*	
*	 	 	 	 	 	 	 	 	 	*	 	 	 	 	*	
*	*	*	*	*	*	*	*	*	 	*	 	*	*	*	*	
*	 	 	 	 	 	 	 	 	 	*	 	 	 	 	*	
*	 	 	 	 	 	 	 	 	 	*	 	 	 	 	*	
*	 	 	 	 	 	 	 	 	 	*	 	 	 	 	*	
*	 	 	 	 	 	 	 	 	 	 	 	 	 	 	*	
*	 	 	 	 	 	 	 	 	 	*	 	 	 	 	*	
*	 	 	 	 	 	 	 	 	 	*	 	 	 	 	*	
*	 	 	 	 	 	 	 	 	 	*	 	 	 	 	*	
*	*	*	*	*	*	*	*	*	*	*	*	*	*	*	*	
##
2	2
13	12
##
