*	*	*	*	*	*	*	*	*	
*	 	 	 	 	 	 	 	*	
*	 	 	 	 	 	 	 	*	
*	 	 	 	 	 	 	 	*	
*	 	 	 	 	 	 	 	*	
*	 	 	 	 	 	 	 	*	
*	 	 	 	 	 	 	 	*	
*	 	 	 	 	 	 	 	*	
*	 	 	 	 	 	 	 	*	
*	 	 	 	 	 	 	 	*	
*	*	*	*	*	*	*	*	*	
##
1	6	
8	2	
##
7	3	1	
1	2	1	
6	6	2	
