*	*	*	*	*	*	*	*	
*	 	 	 	 	 	 	*	
*	 	 	 	 	 	 	*	
*	 	 	 	 	 	 	*	
*	 	 	 	 	 	 	*	
*	 	 	 	 	 	 	*	
*	 	 	 	 	 	 	*	
*	*	*	*	*	*	*	*	
##
3	1
3	6
##
3	4	1	
5	4	1	
1	4	1	