*	*	*	*	*	*	*	*	*	*	*	*	
*	 	 	 	 	 	*	 	 	 	 	*	
*	 	 	 	 	 	*	 	 	 	 	*	
*	 	 	 	 	 	*	 	 	 	 	*	
*	 	 	 	 	 	*	 	 	 	 	*	
*	 	 	 	 	 	*	 	 	 	 	*	
*	 	 	 	 	 	 	 	 	 	 	*	
*	*	*	*	*	*	*	*	*	*	*	*	
##
5	1
1	9
##
4	4	1	
6	7	1	
2	10	1	
2	5	1	
4	10	1	
2	3	1	
