*	*	*	*	*	*	*	*	*	*	
*	 	 	 	*	 	 	 	 	*	
*	 	 	 	*	 	 	 	 	*	
*	 	 	 	 	 	 	 	 	*	
*	 	 	 	*	 	 	 	 	*	
*	 	 	 	*	 	 	 	 	*	
*	 	 	 	*	 	 	 	 	*	
*	*	*	*	*	*	*	*	*	*	
##
6	2	
2	8	
##
1	3	1	
3	7	2	
6	5	3	
