*	*	*	*	*	*	*	*	*	
*	 	 	 	*	 	 	 	*	
*	 	 	 	*	 	 	 	*	
*	 	 	 	 	 	 	 	*	
*	 	 	 	*	 	 	 	*	
*	 	 	 	*	 	 	 	*	
*	 	 	 	*	 	 	 	*	
*	*	*	*	*	*	*	*	*	
##
2	2	
6	7	
##
5	2	1	
6	6	1	
3	5	2	
