*	*	*	*	*	*	*	*	*	*	*	*	
*	 	 	*	 	 	 	 	 	 	 	*	
*	 	 	*	 	 	 	 	 	 	 	*	
*	 	 	*	 	 	 	 	 	 	 	*	
*	 	 	 	 	 		 	 	 	 	*	
*	 	 	*	 	 	 	 	 	 	 	*	
*	 	 	*	 	 	 	 	 	 	 	*	
*	*	*	*	*	*	*	*	*	*	*	*	
##
3	1
3	10
##