*	*	*	*	*	*	*	*	*	
*	 	 	 	*	 	 	 	*	
*	 	 	 	*	 	 	 	*	
*	 	 	 	 	 	 	 	*	
*	 	 	 	*	 	 	 	*	
*	 	 	 	*	 	 	 	*	
*	 	 	 	*	 	 	 	*	
*	*	*	*	*	*	*	*	*	
##
6	2
6	7
##
2	3	2
4	7	2
